0 0 0 0 0 0 0 0 0 0 0 0 0 0 0 0 0 0 0 0 0 0 0 0 0 0 0 0 0 0 0 0 0 44 44 44 44 44 44 44 44 44 44 44 44 44 44 44 44 0 0 0 0 0 0 0 1 1 1 1 1 1
1 1 1 1 1 1 1 1 1 1 1 1 1 1 1 1 1 1 1 1 1 1 1 1 1 1 1 1 1 1 1 1 1 44 44 44 44 47 47 47 47 47 47 47 47 44 44 44 44 1 1 1 1 1 1 1 1 1 1 1 1 1
1 1 1 1 1 1 1 1 1 1 1 1 1 1 1 1 1 1 1 1 1 1 1 1 1 1 1 1 1 1 1 1 1 44 44 44 44 44 44 44 44 44 44 44 44 44 44 44 44 1 1 1 1 1 1 1 1 1 1 1 1 1 
1 1 1 1 1 1 1 1 1 1 1 1 1 1 1 1 1 1 1 1 1 1 1 1 1 1 1 1 1 1 1 1 1 44 44 44 47 47 47 47 47 47 47 47 47 47 44 44 44 1 1 1 1 1 1 1 1 1 1 1 1 1 
1 1 1 1 1 1 1 1 1 1 1 1 1 1 1 1 1 1 1 1 1 1 1 1 1 1 1 1 1 1 1 1 1 44 44 44 44 44 44 44 44 44 44 44 44 44 44 44 44 1 1 1 1 1 1 1 1 1 1 1 1 1 
1 1 1 1 1 1 2 2 2 2 2 2 2 2 1 1 1 1 1 1 1 1 1 1 1 1 1 1 1 1 1 1 2 44 44 47 47 47 47 47 47 47 47 47 47 47 47 44 44 2 1 1 1 1 1 1 1 1 1 1 1 1 
1 1 1 1 1 1 33 33 33 33 33 33 33 33 1 1 1 1 1 1 1 1 1 1 1 1 1 1 1 1 1 1 3 44 44 44 44 44 44 44 44 44 44 44 44 44 44 44 44 3 1 1 1 1 1 1 1 1 1 1 1 1 
1 1 1 1 1 1 33 47 47 47 47 47 47 33 2 2 2 2 2 2 2 2 2 2 2 2 2 2 2 2 2 2 3 44 47 47 47 47 47 47 47 47 47 47 47 47 47 47 44 3 1 1 1 1 1 1 1 1 1 1 1 1 
1 1 1 1 1 1 33 12 5 5 5 5 9 47 3 3 3 3 3 3 3 3 3 3 3 3 3 3 3 3 0 3 3 44 44 44 44 44 44 44 44 44 44 44 44 44 44 44 44 3 1 1 2 2 2 1 1 1 1 1 1 1 
1 1 1 1 1 1 33 11 4 4 4 4 4 5 5 5 5 5 5 5 5 5 5 5 5 5 5 5 5 9 2 3 3 47 47 47 47 47 47 47 47 47 47 47 47 47 47 47 47 3 1 1 12 5 9 1 1 1 1 1 1 1 
1 1 1 1 1 1 33 11 4 4 4 4 4 6 6 6 4 6 6 6 6 6 6 6 6 6 6 6 6 4 9 3 3 11 30 16 20 20 16 16 19 19 16 16 20 20 16 29 8 3 1 1 11 4 8 1 1 1 1 1 1 1
1 1 1 1 1 1 33 13 6 6 6 6 10 33 3 3 14 3 0 0 0 0 0 0 0 0 0 0 3 11 8 3 3 11 30 22 24 24 23 17 25 26 18 22 24 24 23 29 8 3 1 1 13 4 10 1 1 1 1 1 1 1 
1 1 1 1 1 1 33 33 33 33 33 33 33 33 0 3 14 3 1 1 1 1 1 1 1 1 1 1 3 11 8 3 3 11 30 16 37 38 16 17 27 28 18 16 37 38 16 29 8 3 1 1 0 14 0 1 1 1 1 1 1 1 
1 1 1 1 1 1 47 47 47 47 47 47 47 47 1 3 14 3 2 2 2 2 2 2 2 1 1 1 3 11 8 3 3 11 32 19 19 19 31 56 56 56 56 32 19 19 19 31 8 3 2 2 2 14 1 1 1 1 1 1 1 1 
1 1 1 1 1 1 0 0 0 0 0 0 0 0 1 3 13 7 7 7 7 7 7 9 3 1 1 1 3 11 8 3 3 13 6 6 6 6 6 6 6 6 6 6 6 6 6 6 6 7 7 7 7 10 1 1 1 1 1 1 1 1 
1 1 1 1 1 1 1 1 1 1 1 1 1 1 1 0 0 0 0 0 0 0 3 14 3 1 1 1 3 11 8 3 3 3 3 3 3 3 3 3 3 3 3 3 3 3 0 3 3 3 0 0 0 0 1 1 1 1 1 1 1 1 
1 1 1 1 1 1 1 1 1 1 1 1 1 1 1 1 1 1 1 1 1 1 3 14 3 1 1 1 3 11 8 3 3 3 3 3 3 3 3 3 3 3 3 3 3 3 2 0 3 3 2 2 2 2 2 1 1 1 1 1 1 1 
1 1 1 1 1 1 1 1 1 1 1 1 1 1 1 1 1 1 1 1 1 1 3 14 3 1 1 1 3 13 6 7 7 7 9 3 3 3 3 3 3 3 3 48 49 49 50 2 3 3 5 5 5 5 5 1 1 1 1 1 1 1 
1 1 1 1 1 1 1 1 1 1 1 1 1 1 1 1 1 1 1 1 1 1 3 14 3 1 1 1 3 3 3 3 3 3 14 3 3 3 3 3 3 3 3 51 15 15 52 3 3 3 6 6 6 6 6 1 1 1 1 1 1 1 
1 1 1 1 1 1 1 2 2 2 1 1 1 1 1 1 1 1 1 1 1 1 3 14 3 1 1 1 0 0 3 3 3 3 14 3 3 3 3 3 3 3 3 51 15 15 52 3 0 0 0 0 0 0 0 1 1 1 1 1 1 1 
1 1 1 1 1 1 1 12 5 9 1 1 1 1 1 1 1 1 1 1 1 1 3 14 3 1 1 1 1 1 0 0 0 3 14 3 3 3 3 3 0 0 0 53 54 54 55 0 1 1 1 1 1 1 1 1 1 1 1 1 1 1 
1 1 1 1 1 1 1 11 4 8 1 1 1 1 1 1 1 1 1 1 1 1 3 14 3 1 1 1 1 1 1 1 1 3 14 3 3 3 3 0 1 1 1 0 0 0 0 1 1 1 1 1 1 1 1 1 1 1 1 1 1 1 
1 1 1 1 1 1 1 13 4 10 1 1 1 1 1 1 1 2 2 2 2 2 3 14 3 1 1 1 1 1 1 2 2 3 14 3 3 3 3 1 1 1 1 1 1 1 1 1 1 1 1 1 1 1 1 1 1 1 1 1 1 1 
1 1 1 1 1 1 1 0 14 0 1 1 1 1 1 1 1 3 12 7 7 7 7 10 3 1 1 1 1 1 2 3 3 12 4 9 3 3 3 1 1 1 1 2 2 2 2 2 2 1 1 1 1 1 1 1 1 1 1 1 1 1 
1 1 1 1 1 1 1 1 14 2 2 2 2 1 1 1 1 3 14 3 0 0 0 0 0 1 1 1 1 1 3 3 3 11 4 8 3 3 3 1 1 1 1 3 3 3 3 3 3 1 1 1 1 1 1 1 1 1 1 1 1 1 
1 1 1 1 1 1 1 2 13 7 7 9 3 1 1 1 1 3 14 3 1 1 1 1 1 1 1 1 1 1 3 3 3 13 6 10 3 3 3 1 1 1 1 3 12 5 5 9 3 1 1 1 1 1 1 1 1 1 1 1 1 1 
1 1 1 1 1 1 1 3 3 3 3 14 3 1 1 1 1 3 14 3 1 1 1 1 1 1 1 1 1 1 0 0 0 0 0 0 0 3 0 1 1 1 1 3 11 4 4 8 3 1 2 2 2 1 1 1 1 1 1 1 1 1 
1 1 1 1 1 1 1 48 49 50 3 14 3 1 1 1 2 3 14 3 1 1 1 1 1 1 1 1 1 1 1 1 1 1 1 1 1 0 1 1 1 1 1 3 11 4 4 8 3 1 12 5 9 1 1 1 1 1 1 1 1 1 
1 1 1 1 1 1 1 51 15 52 3 14 3 2 2 2 3 3 14 3 2 1 1 1 1 1 1 1 1 1 1 1 1 1 1 1 1 1 1 1 1 1 1 3 13 4 4 10 3 1 11 4 8 1 1 1 1 1 1 1 1 1 
1 1 1 1 1 1 1 53 54 55 3 14 3 3 3 3 3 3 14 3 3 2 2 2 2 2 2 2 1 1 1 1 1 1 1 1 1 1 1 1 1 1 1 3 3 11 8 3 3 1 13 4 10 1 1 1 1 1 1 1 1 1 
1 1 1 1 1 1 1 0 0 0 3 13 7 7 7 5 5 5 8 3 3 3 3 3 3 3 3 3 1 1 1 1 1 1 1 1 1 1 1 1 1 1 1 0 3 11 8 3 0 1 0 14 0 1 1 1 1 1 1 1 1 1 
1 1 1 1 1 1 1 1 1 1 3 3 3 3 3 11 4 4 4 5 5 5 5 5 5 5 9 3 1 1 1 1 1 1 1 1 1 1 1 1 1 1 1 1 3 11 8 3 1 1 1 14 1 1 1 1 1 1 1 1 1 1 
1 1 1 1 1 1 1 1 1 1 0 3 3 3 3 11 4 4 4 6 6 6 6 6 6 4 8 3 1 1 1 1 1 1 1 2 2 2 2 2 2 2 1 1 3 11 8 3 2 2 2 14 1 1 1 1 1 1 1 1 1 1 
1 1 1 1 1 1 1 1 1 1 1 0 3 3 3 11 6 6 10 3 3 3 3 3 3 11 8 3 2 2 2 2 2 2 2 3 3 3 3 3 3 3 2 1 3 11 4 7 7 7 7 10 1 1 1 1 1 1 1 1 1 1
1 1 1 1 1 1 1 1 1 1 1 1 0 3 3 14 3 3 3 3 0 0 0 0 3 11 8 3 3 3 3 3 3 3 3 3 12 5 5 5 9 3 3 2 3 11 8 3 0 0 0 0 1 1 1 1 1 1 1 1 1 1
1 1 1 1 1 1 1 1 2 2 2 1 1 0 0 14 0 0 0 0 1 1 1 1 3 11 4 5 5 5 5 5 5 5 5 5 4 4 4 4 4 9 3 3 3 11 8 3 1 1 1 1 1 1 1 1 1 1 1 1 1 1 
1 1 1 1 1 1 1 1 12 5 9 2 2 2 2 14 1 1 1 1 1 1 1 1 3 13 6 6 6 6 6 6 6 6 6 4 4 4 4 4 4 4 5 5 5 4 8 3 1 1 1 1 1 1 1 1 1 1 1 1 1 1
1 1 1 1 1 1 1 1 11 4 4 7 7 7 7 10 1 1 1 1 1 1 1 1 3 3 3 3 3 3 3 3 3 3 3 11 4 4 4 4 4 4 6 6 6 6 10 3 1 1 1 1 1 1 1 1 1 1 1 1 1 1
1 1 1 1 1 1 1 1 13 6 10 0 0 0 0 0 1 1 1 1 1 1 1 1 0 0 0 0 0 0 0 0 0 0 3 13 6 6 4 6 6 10 3 3 3 3 0 0 2 1 1 1 1 1 1 1 1 1 1 1 1 1
1 1 1 1 1 1 1 1 0 0 0 1 1 1 1 1 1 1 1 1 1 1 1 1 1 1 1 1 1 1 1 1 1 1 3 3 3 3 14 3 3 3 3 3 3 3 2 2 3 2 1 1 1 1 1 1 1 1 1 1 1 1
1 1 1 1 1 1 1 1 1 1 1 1 1 1 1 1 1 1 1 1 1 1 1 1 1 1 1 1 1 1 1 1 1 1 0 0 0 3 14 3 48 49 49 50 3 3 3 3 3 3 2 2 2 2 2 2 1 1 1 1 1 1
1 1 1 1 1 1 1 1 1 1 1 1 1 1 1 1 1 1 1 1 1 1 1 1 1 1 1 2 2 2 2 2 2 2 2 2 2 3 14 3 51 15 15 15 49 49 49 49 49 49 49 49 49 49 49 49 1 1 1 1 1 1
1 1 1 1 1 1 1 1 1 2 2 2 2 2 2 1 1 1 1 1 1 1 1 1 1 1 1 3 3 3 3 3 3 3 3 3 3 3 14 3 51 15 15 15 15 15 15 15 15 15 15 15 15 15 15 15 1 1 1 1 1 1
1 1 1 1 1 1 1 1 2 3 3 3 3 3 3 2 1 1 1 1 1 1 1 1 1 1 1 3 12 7 7 7 7 7 7 7 7 7 10 3 51 15 15 15 15 15 15 15 15 15 15 15 15 15 15 15 1 1 1 1 1 1
1 1 1 1 1 1 2 2 3 3 3 3 3 3 3 3 2 2 2 2 2 2 2 2 2 2 2 3 14 3 0 3 48 49 49 49 49 49 49 49 15 15 15 15 15 15 15 15 15 15 15 15 15 15 15 15 1 1 1 1 1 1 
1 1 1 1 1 1 3 3 3 12 5 5 5 5 9 3 3 3 3 3 3 3 3 3 3 3 3 3 14 3 2 3 51 15 15 15 15 15 15 15 15 15 15 15 15 15 15 15 15 15 15 15 15 15 15 15 1 1 1 1 1 1
1 1 1 1 1 1 3 3 7 4 4 4 4 4 4 7 7 7 7 7 7 7 7 7 7 7 7 7 10 3 3 3 15 15 15 15 15 15 15 15 15 15 15 15 15 15 15 15 15 15 15 15 15 15 15 15 1 1 1 1 1 1
1 1 1 1 1 1 3 3 3 13 6 6 6 6 10 3 3 3 3 3 3 3 3 3 3 3 3 3 3 48 49 49 15 15 15 15 15 15 15 15 15 15 15 15 15 15 15 15 15 15 15 15 15 15 15 15 1 1 1 1 1 1
1 1 1 1 1 1 0 0 3 3 3 3 3 3 3 3 0 0 0 0 0 0 0 0 0 0 0 0 0 51 15 15 15 15 15 15 15 15 15 15 15 15 15 15 15 15 15 15 15 15 15 15 15 15 15 15 1 1 1 1 1 1
1 1 1 1 1 1 1 1 0 3 3 3 3 3 3 0 1 1 1 1 1 1 1 1 1 1 1 1 1 51 15 15 15 15 15 15 15 15 15 15 15 15 15 15 15 15 15 15 15 15 15 15 15 15 15 15 1 1 1 1 1 1
1 1 1 1 1 1 1 1 1 0 0 0 0 0 0 1 1 1 1 1 1 1 1 1 1 1 1 1 1 51 15 15 15 15 15 15 15 15 15 15 15 15 15 15 15 15 15 15 15 15 15 15 15 15 15 15 1 1 1 1 1 1
1 1 1 1 1 1 1 1 1 1 1 1 1 1 1 1 1 1 1 1 1 1 1 1 1 1 1 1 1 51 15 15 15 15 15 15 15 15 15 15 15 15 15 15 15 15 15 15 15 15 15 15 15 15 15 15 1 1 1 1 1 1
1 1 1 1 1 1 1 1 1 1 1 1 1 1 1 1 1 1 1 1 1 1 1 1 1 1 1 1 1 51 15 15 15 15 15 15 15 15 15 15 15 15 15 15 15 15 15 15 15 15 15 15 15 15 15 15 1 1 1 1 1 1
1 1 1 1 1 1 1 1 1 1 1 1 1 1 1 1 1 1 1 1 1 1 1 1 1 1 1 1 1 51 15 15 15 15 15 15 15 15 15 15 15 15 15 15 15 15 15 15 15 15 15 15 15 15 15 15 1 1 1 1 1 1
1 1 1 1 1 1 1 1 1 1 1 1 1 1 1 1 1 1 1 1 1 1 1 1 1 1 1 1 1 51 15 15 15 15 15 15 15 15 15 15 15 15 15 15 15 15 15 15 15 15 15 15 15 15 15 15 1 1 1 1 1 1
1 1 1 1 1 1 1 1 1 1 1 1 1 1 1 1 1 1 1 1 1 1 1 1 1 1 1 1 1 51 15 15 15 15 15 15 15 15 15 15 15 15 15 15 15 15 15 15 15 15 15 15 15 15 15 15 1 1 1 1 1 1